XXXXXXXXXXXXXXXXXXXXXXXXXXXXXXXXXXXXXXXX
XXXXXXXXXXXXXXXXX______XXXXXXXXXXXXXXXXX
XXXXXXXXXXXXX______________XXXXXXXXXXXXX
XXXXXXXXX______________________XXXXXXXXX
XXXX____________X------X___________XXXXX
X+++++++X_______X------X_______X+++++++X
X+++++++X_______X------X_______X+++++++X
X______________________________________X
X----X----X++++XX++++++XX++++X----X----X
X----X----X++++XX++++++XX++++X----X----X
X----X_________XX++++++XX_________X----X
X----X____X____XX++++++XX____X____X----X
X______________________________________X
X++++X____X____X---XX---X____X____X++++X
X++++X____X____X---XX---X____X____X++++X
X++++X++++_----X---XX---X----_++++X++++X
X++++X++++X----X---XX---X----X++++X++++X
X______________________________________X
X++++X++++X____X---XX---X____X++++X++++X
X++++X++++X____X---XX---X____X++++X++++X
X++++X++++X____X--------X____X++++X++++X
X++++X++++X____X________X____X++++X++++X
X______________________________________X
X____________X____________X____________X
XX__________XXX__________XXX__________XX
XXX________XXXXX________XXXXX________XXX
XXXX______XXXXXXX______XXXXXXX______XXXX
XXXXX____XXXXXXXXX____XXXXXXXXX____XXXXX
XXXXXX__XXXXXXXXXXX__XXXXXXXXXXX__XXXXXX
XXXXXXXXXXXXXXXXXXXXXXXXXXXXXXXXXXXXXXXX
