XXXXXXXXXXXXXXXXXXXXXXXXXXXXXXXXXXXXXXXX
XXXXXXXXXXXXXXXXXXX+XXXXXXXXXXXXXXXXXXXX
XXXXXXXXXXXXXXXXXX+++XXXXXXXXXXXXXXXXXXX
XXXXXXXXXXXXXXXXXX+++XXXXXXXXXXXXXXXXXXX
XXXXXX+++XXXXXXXXX+++XXXXXXXXX+++XXXXXXX
XXXXXX++++XXXXXXX+++++XXXXXXX++++XXXXXXX
XXXXXXX++++XXXXXX+++++XXXXXX++++XXXXXXXX
XXXXXXXX+++++XXXX+++++XXXX+++++XXXXXXXXX
XXXXXXXXX+++++XXX+++++XXX+++++XXXXXXXXXX
XXXXXXXXXX+++++XX+++++XX+++++XXXXXXXXXXX
XXXXXXXXXXX+++++X+++++X+++++XXXXXXXXXXXX
XXXXXXXXXXXX+++++++++++++++XXXXXXXXXXXXX
XXXXXXXXXXXXX+++++++++++++XXXXXXXXXXXXXX
XXXXXXXX+++++++++++++++++++++++XXXXXXXXX
XXX+++++++++++++++X+X+++++++++++++++XXXX
XX+++++++++++++++++-+++++++++++++++++XXX
XXX+++++++++++++++X+X+++++++++++++++XXXX
XXXXXXXX+++++++++++++++++++++++XXXXXXXXX
XXXXXXXXXXXX+++++++++++++++XXXXXXXXXXXXX
XXXXXXXXXXX+++++X+++++X+++++XXXXXXXXXXXX
XXXXXXXXXX+++++XX+++++XX+++++XXXXXXXXXXX
XXXXXXXXX+++++XXX+++++XXX+++++XXXXXXXXXX
XXXXXXXX+++++XXXX+++++XXXX+++++XXXXXXXXX
XXXXXXX++++XXXXXX+++++XXXXXX++++XXXXXXXX
XXXXXX++++XXXXXXX+++++XXXXXXX++++XXXXXXX
XXXXXX+++XXXXXXXXX+++XXXXXXXXX+++XXXXXXX
XXXXXXXXXXXXXXXXXX+++XXXXXXXXXXXXXXXXXXX
XXXXXXXXXXXXXXXXXX+++XXXXXXXXXXXXXXXXXXX
XXXXXXXXXXXXXXXXXXX+XXXXXXXXXXXXXXXXXXXX
XXXXXXXXXXXXXXXXXXXXXXXXXXXXXXXXXXXXXXXX
