XXXXXXXXXXXXXXXXXXXXXXXXXXXXXXXXXXXXXXXX
XXX--XXX--XXXXXXXXX--XXXXXXXX-XXXX----XX
XX-XX-X-XX-XXXXXXXX--XXXXXXXX-XXXX-XXXXX
XX-XXXX-XX-XXXXXX------XXXXXX-XXXX-XXXXX
XX-XXXX-XX-XXXXXX------XXXXXX-XXXX----XX
XX-X--X-XX-XXXXXX------XXXXXX-XXXX-XXXXX
XX-XX-X-XX-XXXX----------XXXX-XXXX-XXXXX
XXX--XXX--XXXXX----------XXXX----X-XXXXX
XXXXXXXXXXXXXXX__________XXXXXXXXXXXXXXX
XXXXXXXXXXXXX______________XXXXXXXXXXXXX
XXXXXXXXXXXXX__XXXXXXXXXXXXXXHHHHHHXXXXX
XXXXXXXXXXX_-+_-+_-+_-+_-+_-+_____HXXXXX
XXXXXXXXXXX-+_-+_-+_-+_-+_-+_HHHH_HXXXXX
XXXXXXXXXXXXXXXXXXXXXXXXXXXXXHHHH_HXXXXX
XXXXXXXXX_______HHHH______HHHH____HXXXXX
XXXXXXXXX__HHHH______HHHH______HHHHXXXXX
XXXXXXXXX__XXXXXXXXXXXXXXXXXXXXXXXXXXXXX
XXXXXXX____H___H_________H___H___XXXXXXX
XXXXXXX______H___H_____H___H_____XXXXXXX
XXXXXXXXXXXXXXXXXXXXXXXXXXXXXXX--XXXXXXX
XXXXX__++++++++++++++++++++++++++++XXXXX
XXXXX__++++++++++++++++++++++++++++XXXXX
XXXXX__XXXXXXXXXXXXXXXXXXXXXXXXXXXXXXXXX
XXX_____X_____X_____X_____X_____X____XXX
XXX________X_____X_____X_____X_______XXX
XXXXXXXXXXXXXXXXXXXXXXXXXXXXXXXXX____XXX
X______________________________________X
X______________________________________X
X______________________________________X
X______________________________________X
XXXXXXXXXXXXXXXXXXXXXXXXXXXXXXXXXXXXXXXX
