HHHHHHHHHHHHHHHHHHHHHHHHHHHHHHHHHHHHHHHH
H______________________________________H
H___________________________HH_H_______H
H____________________HHH__H-----_______H
H____________________-----------H__HHH_H
H____________________-HHH----H-------__H
H_________________HHH-----HH----HH-H___H
H__________________----HH-----H------H_H
H_______________HHH-HH----HHH---HH-H--HH
H_______H________-------H--------------H
H___HH_HHH_H_____--HHHH---HHH--HHH--HH-H
H___---------___H-------H--------------H
H_H--HH-HHH---_---HHHHH---HHHH--HHHH---H
H_-----------HHH-----------------------H
HH-HHHH--HHH-----HH--HHH---HHHH--HH--H_H
HH-HHHH--HHH-----HH--HHH---HHHH--HH--H_H
H_-----------HHH-----------------------H
H_HH-HH-HHH---_---HHHHH---HHHH--HHHH---H
H___--------H___H-------H--------------H
H___HH_HHH_H_____--HHHH---HHH--HHH--HH-H
H_______H________-------H--------------H
H_______________HHH-HH----HHH---HH-H--HH
H__________________----HH-----H------H_H
H_________________HHH-----HH----HH-H___H
H____________________-HHH----H-------__H
H____________________-----------H__HHH_H
H____________________HHH__H-----_______H
H___________________________HH_H_______H
H______________________________________H
HHHHHHHHHHHHHHHHHHHHHHHHHHHHHHHHHHHHHHHH
