HHHHHHHHHHHHHHHHHHHHHHHHHHHHHHHHHHHHHHHH
H____________H____HHHHHHH________H_H___H
H___HHHHHHHH_HH_H_______H_HHHHHH_______H
H___H___________HHHHHH_HH_H______H_H___H
H_HHH__H_HH_HHHHH_______H_H_HHHHHH_HHH_H
H_H___HH_H__H_____HHHHH___H_H____H_H___H
H_H_H__H_H_HHHHHH_H___HHHHH_HHHH_H_H_HHH
H_HHHHHH_H________H_HHH______H_______H_H
H_____H_____HHHHH_H______HHHHHHHHHHH___H
HHH_HHHH_HH_____H____H_H____HH_______H_H
H___H____HHHHHH_HHHHHH_HHHHH___HHH_H_H_H
H_HHH_H__H____H_H__H_________H__H__H_H_H
H___HHHH_H__H___HH_HH_HHHHHHHHH_HHHH_HHH
H____H_H____HHH_________H________H_____H
HHHH___H_HH___HH_H_--_H_HH_HHH_HHH_H_HHH
H__H_HHHHH__HHHH_H_--_H_H____H_H_H_H_H_H
HH_H____HH__H___________HHHHHH_H_H_____H
H____HH_____HH_HHH_HH_H__H___H_H___HHHHH
HHH_HHHHHHH_HH_H_HHH__HHHH_H_H_H_H_H___H
H______H____HH_____H_____HHH_____H___H_H
HHHHHH_H_HH_HHHHHH_HH_H__H___H_H_HHH_H_H
H_H____HHH___H_____HH_H__HHHHH_H_______H
H_H_HH_____H___HHH____HH___H_H_HHHHH_HHH
H_H__HHHHH_HHHHH_HHH_HHHHH_H____H____H_H
H________________________H_H_HH_H_HH_H_H
HHH_HHH_HHHHH_HHHH_HHH_H___H__H_H_H__HHH
H___H__________H_H_H_HHH_H_HH_____HH___H
H___HHHHHH_HHH_H_______H_H__HH_HH______H
H__________H___HHHHHH_HH_HH_____H_HH___H
HHHHHHHHHHHHHHHHHHHHHHHHHHHHHHHHHHHHHHHH
