XXXXXXXXXXXXXXXXXXXXXXXXXXXXXXXXXXXXXXXX
X++++++++++++++++++++++++++++++++++++++X
X-+-+H+-+_+_+_+-+H+X+H+_+_+H+H+-+-+H+H+X
X++++++++++++++++++++++++++++++++++++++X
X-+_+H+H+H+H+_+_+-+X+_+H+-+_+X+H+X+H+-+X
X++++++++++++++++++++++++++++++++++++++X
XX+X+-+H+X+_+_+_+H+-+X+X+-+-+X+_+-+-+H+X
X++++++++++++++++++++++++++++++++++++++X
X-+_+X+_+H+-+_+X+_+-+_+X+H+H+H+_+H+-+X+X
X++++++++++++++++++++++++++++++++++++++X
X_+-+-+H+H+_+_+X+_+X+H+-+-+X+-+X+_+-+H+X
X++++++++++++++++++++++++++++++++++++++X
X-+H+-+_+H+X+X+X+H+-+H+_+-+-+_+-+H+-+H+X
X++++++++++++++++++++++++++++++++++++++X
XX+-+H+_+-+_+-+X+H+H+-+X+X+H+_+-+-+_+X+X
X++++++++++++++++++++++++++++++++++++++X
XH+X+X+-+X+-+_+-+-+X+X+_+-+_+-+X+X+_+X+X
X++++++++++++++++++++++++++++++++++++++X
XX+_+X+-+X+_+-+X+H+_+-+H+X+X+X+H+X+H+_+X
X++++++++++++++++++++++++++++++++++++++X
X_+_+_+-+H+X+_+-+X+_+_+X+_+-+H+H+X+_+H+X
X++++++++++++++++++++++++++++++++++++++X
XX+_+X+-+_+_+X+H+-+X+X+-+X+X+-+_+X+-+_+X
X++++++++++++++++++++++++++++++++++++++X
X_+-+++H+-+X+_+H+_+_+X+_+-+X+X+-+_+H+_+X
X++++++++++++++++++++++++++++++++++++++X
XH+-+_+X+-+X+-+_+-+H+-+-+_+-+H+-+H+H+H+X
X++++++++++++++++++++++++++++++++++++++X
XX+_+X+-+H+-+X+-+_+H+H+H+-+H+X+_+_+_+-+X
XXXXXXXXXXXXXXXXXXXXXXXXXXXXXXXXXXXXXXXX
