XXXXXXXXXXXXXXXXXXXXXXXXXXXXXXXXXXXXXXXX
XXXXXXXXXXXXXXXX______XXXXXXXXXXXXXXXXXX
XXXXXXXXXXXXXXXX______XXXXXXXXXXXXXXXXXX
XXXXXXXXXXXXXXXX______XXXXXXXXXXXXXXXXXX
XXXXXXXXXXXXXXXXX+XX+XXXXXXXXXXXXXXXXXXX
XXXXXXXXXXXXXXXXX+XX+XXXXXXXXXXXXXXXXXXX
XXXXXXXXXXXXXXXXX+XX+XXXXXXXXXXXXXXXXXXX
XXXXXXXXXXXXXXXXX+XX+XXXXXXXXXXXXXXXXXXX
XXXXXXXXXXXXXXH__----__HXXXXXXXXXXXXXXXX
XXXXXXXXXXXXXHH________HHXXXXXXXXXXXXXXX
XXXXXXXXXXXXXHH________HHXXXXXXXXXXXXXXX
XXXXXXXXXXXXX++++++++++++XXXXXXXXXXXXXXX
XXXXXXXXXXXXX++++++++++++XXXXXXXXXXXXXXX
XXXXXXXXXXXXX++++++++++++XXXXXXXXXXXXXXX
XXXXXXXXXXXXX++++++++++++XXXXXXXXXXXXXXX
XXXXXXXXXXXXX++++++++++++XXXXXXXXXXXXXXX
XXXXXXXXXXXXX++++++++++++XXXXXXXXXXXXXXX
XXXXXXXXXXXXX++++++++++++XXXXXXXXXXXXXXX
XXXXXXXXXXXXX++++++++++++XXXXXXXXXXXXXXX
XXXXXXXXXXXXX++++++++++++XXXXXXXXXXXXXXX
XXXXXXXXXXXXX++++++++++++XXXXXXXXXXXXXXX
XXXXXXXXXXXXX++++++++++++XXXXXXXXXXXXXXX
XXXXXXXXXXXXX++++++++++++XXXXXXXXXXXXXXX
XXXXXXXXXXXXX++++++++++++XXXXXXXXXXXXXXX
XXXXXXXXXXXXX++++++++++++XXXXXXXXXXXXXXX
X____________++++++++++++______________X
XXXXXXXXXXXXXX__________XXXXXXXXXXXXXXXX
XXXXXXXXXXXXXXX________XXXXXXXXXXXXXXXXX
XXXXXXXXXXXXXXXXXXXXXXXXXXXXXXXXXXXXXXXX
XXXXXXXXXXXXXXXXXXXXXXXXXXXXXXXXXXXXXXXX
XXXXXXXXXXXXXXXXXXXXXXXXXXXXXXXXXXXXXXXX
